111111111111
1P00100001E1
100010010101
100010010101
1000C0010001
101111010001
100100011111
110111000001
100000011101
11111101C101
1C0000010001
111111111111
